d	de	Art(def)
'	?	punc(quest)
edel	edel	Adj()
orangien	oranje	N(prop)
stam	stam	N(sing)
moet	moeten	V(fin,pres,aux_cop)
hoogh	hoog	Adj()
verheven	verheffen	V(participle,past)
leven	leven	V(infin)
al	al	Adv(gener)
sou	zullen	V(fin,past,aux_cop)
al	al	Adv(gener)
spangien	spanje	v(infin)
gram	gram	Adj()
door	door	adp()
nijt	nijd	n(sing)
ghedreven	drijven	V(participle,past)
beven	beven	V(infin)
schoon	schoon	adj()
bekleven	beklijven	V(infin)
geven	geven	V(infin)
vreught	vreugde	n(sing)
moet	moeten	v(fin,pres,aux_cop)
die	die	pron(rel)
van	van	Adp()
nassouwe	nassau	N(prop)
trouwe	trouw	N(sing)
rouwe	rouw	n(sing)
flouwe	flauw	n(sing)
snel	snel	adj()
ter	de+te	art(def)+adp()
vlucht	vlucht	N(sing)
voor	voor	Adp()
zijn	zijn	Pron(poss)
aenschijn	aanschijn	N(sing)
seer	zeer	Adv(gener)
beducht	beducht	V(participle,past)
desen	deze	Pron(dem)
ghepresen	prijzen	V(participle,past)
heldt	houden	V(fin,pres,lex)
hem	hij	Pron(pers,3,sing)
wel	wel	adv(gener)
gheneghen	genegen	V(participle,past)
teghen	tegen	Adp()
tyranniek	tyrannie	N(sing)
wesen	wezen	V(infin)
stelt	stellen	v(fin,pres,lex)
om	om	adp()
rechte	recht	Adj()
weghen	weg	N(plu)
pleghen	plegen	V(infin)
dus	dus	Adv(dem)
heeft	hebben	V(fin,pres,aux_cop)
zeghen	zege	N(sing)
kregen	krijgen	V(infin)
hy	hij	Pron(pers,3,sing)
godt	god	N(sing)
wil	willen	V(fin,pres,aux_cop)
hem	hij	Pron(pers,3,sing)
behoeden	behoeden	v(infin)
spoeden	spoeden	v(fin,past,lex)
goeden	goed	adj()
vroeden	vroed	adj()
raet	raad	n(sing)
hem	hij	Pron(pers,3,sing)
zy	zij	Pron(pers,3,sing)
met	met	Adp()
ons	ons	Pron(poss)
heeren	heer	N(sing)
staten	staat	N(plu)
bly	blij	Adj()
wilt	willen	V(fin,pres,aux_cop)
hem	hij	Pron(pers,3,sing)
bevryden	bevrijden	V(infin)
heer	heer	N(sing)
uut	uit	Adp()
zijn	zijn	Pron(poss)
vyanden	vijand	N(plu)
handen	hand	N(plu)
die	de	Pron(rel)
fel	fel	adj()
benyden	benijden	V(fin,pres,lex)
seer	zeer	Adv(gener)
alle	al	num(indef)
welstanden	volstaan	N(plu)
vanden	van+de	Adp()+Art(def)
landen	land	N(plu)
branden	branden	N(plu)
schaden	schade	N(sing)
fel	fel	Adj()
hebbende	hebben	v(participle,pres)
vol	vol	Adj()
tooren	toorn	N(sing)
vooren	voren	Adv(gener)
smooren	smoeren	N(plu)
stooren	storen	N(plu)
haer	zij	pron(pers,3,sing)
op	op	Adp()
stel	stellen	N(sing)
wilt	willen	v(fin,pres,aux_cop)
dat	dat	Conj(subord)
niet	niet	adv(neg)
gelucken	gelukken	v(infin)
wel	wel	adv(gener)
god	god	n(sing)
'	?	punc(quest)
t	het	Art(def)
zijnder	zijn	Pron(poss)
glory	glorie	N(sing)
klaer	klaar	Adj()
wilt	willen	V(fin,pres,aux_cop)
goedertieren	goedertieren	Adj()
stieren	stier	N(plu)
hem	hij	pron(pers,3,sing)
die	de	Pron(rel)
victory	victorie	N(sing)
naer	naar	Adp()
waer	waar	V(fin,past,aux_cop)
zijn	zijn	Pron(poss)
banieren	banier	N(plu)
swieren	zweren	V(infin)
dat	dat	conj(subord)
lourieren	logeren	V(infin)
cieren	sieren	V(infin)
schoon	schoon	Adj()
zijn	zijn	Pron(poss)
hooft	hoofd	N(sing)
tot	tot	Adp()
bequame	bekwaam	Adj()
fame	faam	n(sing)
blame	blaam	n(sing)
schame	schamen	n(sing)
syn	zijn	v(fin,pres,aux_cop)
persoon	persoon	N(sing)
te	te	adp()
willen	wil	n(sing)
berooven	beroven	V(infin)
croon	kroon	N(sing)
godt	god	N(sing)
doet	doen	V(fin,pres,lex)
groot	groot	Adj()
wonder	wonder	n(sing)
saen	zaan	Adv(gener)
soo	zo	Adv(resum)
dat	dat	Conj(subord)
in	in	Adp()
vreden	vrede	n(sing)
treden	treden	n(plu)
die	de	Art(def)
staten	staat	N(plu)
onderdaen	onderdaan	Adj()
meer	meer	Num(indef)
en	ne	adv(neg)
meer	meer	Num(indef)
steden	stad	N(plu)
heden	heden	adv(gener)
eendracht	eendracht	N(sing)
zeden	zede	n(plu)
reden	rede	n(sing)
goet	goed	adj()
doet	doen	V(fin,pres,aux_cop)
kleyn	klein	adj()
saken	zaak	N(plu)
groeyen	groeien	adj()
bloeyen	bloeien	v(infin)
boeyen	boei	v(infin)
snoeyen	snood	v(infin)
'	?	punc(quest)
svyandts	zenden	Art(def)+N(sing)
moet	moeten	V(fin,pres,aux_cop)
soo	zo	Adv(resum)
dat	dat	Conj(subord)
neeringh	nering	N(sing)
lacht	lachen	v(fin,past,lex)
met	met	Adp()
spoet	spoed	N(sing)
niet	niet	Adv(neg)
ist	zijn+het	V(fin,pres,aux_cop)+Pron(pers,3,sing)
begonnen	beginnen	V(participle,past)
werck	werk	N(sing)
faelt	falen	V(fin,pres,lex)
u	gij	Pron(poss)
ghenade	genade	n(sing)
stade	stad	n(sing)
hem	hij	pron(pers,3,sing)
die	de	art(def)
ghewonnen	winnen	v(participle,past)
berck	berg	n(sing)
heeft	hebben	V(fin,pres,aux_cop)
slaet	slaan	V(fin,pres,lex)
met	met	Adp()
rade	raad	N(sing)
gade	god	n(sing)
quade	kwaad	adj()
schade	schade	n(sing)
van	van	adp()
hem	hij	pron(pers,3,sing)
went	wanen	V(fin,pres,lex)
helpt	helpen	v(imp)
hem	hij	pron(pers,3,sing)
waer	waar	v(fin,past,aux_cop)
ghenaken	genaken	v(infin)
saken	zaak	n(plu)
waken	waken	v(infin)
maken	maken	v(infin)
goeden	goed	adj()
ent	en+het	conj(coord)+art(def)
tot	tot	adp()
den	de	art(def)
lof	lof	N(sing)
uws	uw	Pron(poss)
naems	naam	N(sing)
bekent	bekend	Adj()
prince	prins	N(sing)
der	de	Art(def)
princen	prins	N(plu)
wilt	willen	V(fin,pres,aux_cop)
doch	doch	Adv(gener)
voor	voor	Adp()
beswaren	bezwaar	V(infin)
sparen	sparen	V(infin)
onse	ons	Pron(poss)
provincen	proeving	n(plu)
milt	mild	V(fin,pres,aux_cop)
laet	laten	v(imp)
goede	goed	adj()
jaren	jaar	n(plu)
naren	naar	n(plu)
waren	zijn	v(fin,past,aux_cop)
varen	varen	v(infin)
breet	breed	adj()
en	een	Conj(coord)
wijt	wijd	pron(pers,3,sing)+pron(pers,1,plu)
spijt	spijt	v(fin,pres,lex)
die	die	Pron(rel)
d	de	Art(def)
'	?	punc(quest)
edel	edel	Adj()
staten	staat	N(plu)
haten	haten	V(infin)
laten	laten	V(infin)
baten	baat	v(infin)
doet	doen	V(fin,pres,lex)
hun	zij	Pron(pers,3,plu)
vlijt	vlijt	N(sing)
tot	tot	Adp()
u	gij	Pron(pers,2,sing)
eer	eer	N(sing)
en	en	Conj(coord)
'	?	punc(quest)
slandts	het+land	Art(def)+N(sing)
profijt	profijt	n(sing)
een	een	Art(indef)
is	zijn	v(fin,pres,aux_cop)
nodich	nijdig	adj()
