looft	loven	V(imp)
den	de	Art(def)
heer	heer	N(sing)
voor	voor	Adp()
dees	deze	Pron(dem)
victory	victorie	N(sing)
vlaemsinwoonders	vlaams	N(plu)
allegaer	algader	Adv(gener)
tis	het+zijn	Pron(pers,3,sing)+V(fin,pres,aux_cop)
noch	noch	Conj(coord)
vers	vers	N(sing)
inde	en	conj(coord)
memory	memorie	n(sing)
hoe	hoe	Adv(inter)
ghy	gij	Pron(pers,2,sing)
langh	lang	Adv(gener)
en	en	Conj(coord)
menigh	menig	Num(indef)
jaer	jaar	n(plu)
hebt	hebben	V(fin,pres,aux_cop)
gheseten	zitten	v(participle,past)
inde	en	Adp()+Art(def)
ly	lijf	N(sing)
van	van	adp()
de	de	Art(def)
spaensche	spaans	Adj()
tyranny	tirannie	N(sing)
luyden	zuiden	N(plu)
die	die	Pron(rel)
d	de	Art(def)
'	?	punc(quest)
afgoden	afgod	N(plu)
haten	haten	v(infin)
mosten	moeten	V(fin,past,aux_cop)
door	door	Adp()
'	?	punc(quest)
t	het	Art(def)
vileyn	vilein	Adj()
ghebroet	broeden	V(participle,past)
hun	zij	Pron(pers,3,plu)
gheboorteplaets	geboorte	V(participle,past)
verlaten	verlaten	V(infin)
want	want	Conj(coord)
men	men	pron(indef)
roofd	roven	N(sing)
'	?	punc(quest)
aen	aan	Adp()
lijf	lijf	N(sing)
en	en	Conj(coord)
goet	goed	adj()
die	die	Pron(rel)
d	de	Art(def)
'	?	punc(quest)
onechte	knecht	N(sing)
babelvrou	babel	N(prop)
niet	niet	adv(neg)
ten	de+te	art(def)+adp()
dienste	dienst	n(sing)
knielen	knielen	v(infin)
wou	willen	v(fin,past,lex)
ons	wij	pron(pers,1,plu)
veldtheer	hij+vellen	N(sing)
met	met	adp()
syn	zijn	Pron(poss)
versamingh	verzaming	N(sing)
is	zijn	V(fin,pres,aux_cop)
godt	god	N(sing)
lof	lof	N(sing)
nu	nu	Adv(dem)
op	op	Adp()
de	de	art(def)
been	been	n(plu)
om	om	adp()
den	de	Art(def)
lang	lang	adj()
verdruckten	verdrukken	V(infin)
vlamingh	vlaming	Adj()
eens	eens	adv(gener)
te	te	adp()
helpen	helpen	V(infin)
uyt	uit	Adp()
gheween	geween	Adj()
en	en	Conj(coord)
hy	hij	Pron(pers,3,sing)
heeft	hebben	V(fin,pres,aux_cop)
tot	tot	Adp()
sulck	zulk	Pron(dem)
ghewin	gewin	N(sing)
'	?	punc(quest)
t	het	Art(def)
gentsche	gans	Adj()
sas	zijn	Adv()
ghekregen	krijgen	v(participle,past)
in	in	adp()
daer	daar	adv(dem)
toe	toe	pronadv(prep)
heeft	hebben	V(fin,pres,aux_cop)
hy	hij	Pron(pers,3,sing)
in	in	Adp()
veel	veel	Num(indef)
schanssen	schans	N(plu)
op	op	Adp()
gheruymt	ruimen	V(participle,past)
een	een	Art(indef)
vrye	vrij	Adj()
pas	pas	n(sing)
meester	meester	n(sing)
maerten	merken	N(plu)
en	en	adv(neg)
de	de	Art(def)
franssen	krans	N(plu)
krygen	krijgen	V(infin)
oock	ook	Adv(gener)
schier	schier	Adv(gener)
al	al	Adv(gener)
den	de	Art(def)
bras	boos	n(sing)
met	met	adp()
haer	haar	Pron(poss)
trompen	trompet	N(plu)
donderwerck	wonderwerk	adj()
dat	dat	conj(subord)
de	de	art(def)
specken	spek	n(plu)
bouwden	bouwen	V(infin)
sterck	sterk	Adj()
hoe	hoe	Adv(inter)
wil	willen	V(fin,pres,aux_cop)
coningh	koning	Adj()
phlippus	filippus	n(prop)
rasen	razen	v(infin)
wraeck	wraak	N(sing)
over	over	Adp()
de	de	Art(def)
ketters	ketter	N(plu)
weer	zijn	Adv(gener)
die	die	Pron(rel)
zijn	zijn	V(fin,pres,aux_cop)
brave	braam	N(sing)
spaensche	spaans	Adj()
basen	base	N(plu)
zoo	zo	Adv(resum)
manhaftigh	maandag	Adj()
gaen	gaan	V(infin)
te	te	adp()
keer	keer	n(sing)
dempend	dempen	adj()
'	?	punc(quest)
inquesicy	inquisitie	N(sing)
moort	moord	N(sing)
om	om	Adp()
de	de	Art(def)
vryheyt	vrijheid	n(sing)
van	van	Adp()
gods	god	N(sing)
woort	woord	N(sing)
hoe	hoe	Adv(inter)
sit	zitten	V(fin,pres,lex)
carels	kerel	n(sing)
pronck	tronk	N(sing)
beslommert	???	V(fin,pres,lex)
nu	nu	Adv(dem)
met	met	Adp()
geusen	geus	N(plu)
voor	voor	Adp()
de	de	Art(def)
wal	wel	N(sing)
hoe	hoe	adv(inter)
loopt	lopen	v(fin,pres,lex)
heerooms	heerloos	N(sing)
vrient	vriend	n(sing)
bekommert	bekommeren	v(participle,past)
bevaert	bevaard	v(participle,past)
na	na	adp()
men	men	pron(indef)
vrou	vrouw	n(sing)
van	van	adp()
hal	half	N(sing)
hoe	hoe	adv(inter)
draegt	dragen	V(fin,pres,lex)
lievens	lief	Adj()
volck	volk	N(sing)
nu	nu	Adv(dem)
om	om	Adp()
'	?	punc(quest)
tbeelt	het+veld	Art(def)+N(sing)
van	van	adp()
lievens	lief	adj()
heylighdom	heiligdom	n(prop)
'	?	punc(quest)
t	het	Art(def)
moedigh	moedig	Adj()
sas	zat	Adv()
is	zijn	V(fin,pres,aux_cop)
nu	nu	adv(dem)
ter	te+de	Adp()+Art(def)
degen	degen	Pron(dem)
voor	voor	Adp()
nassou	nassau	N(prop)
een	een	Art(indef)
open	open	Adj()
deur	door	Adp()
grevelingh	???	N(sing)
is	zijn	V(fin,pres,aux_cop)
ons	wij	pron(pers,1,plu)
niet	niet	Adv(neg)
teghen	tegen	adp()
dats	dat+zijn	pron(dem)+v(fin,pres,aux_cop)
voor	voor	adp()
tromph	troep	n(sing)
een	een	Art(indef)
groot	groot	adj()
faveur	faveur	n(sing)
die	de	Pron(rel)
duynkerck	donker	N(sing)
nu	nu	adv(dem)
na	na	Adp()
zijn	zijn	Pron(poss)
wil	wil	V(fin,pres,aux_cop)
ringneus	ring	N(sing)
met	met	adp()
dien	de	Pron(dem)
papen	paap	n(plu)
bril	breken	n(sing)
god	god	N(sing)
verleen	verlenen	v(fin,pres,lex)
de	de	Art(def)
vlaemsche	vlaams	Adj()
steden	stad	N(plu)
goet	goed	adj()
succes	suiker	n(sing)
om	om	Adp()
tot	tot	Adp()
profijt	profijt	n(sing)
met	met	Adp()
ons	wij	Pron(pers,1,plu)
int	in+het	Adp()+Art(def)
verbondt	verbond	N(sing)
te	te	Adp()
treden	treden	V(infin)
en	en	Conj(coord)
singjeur	se√±or	N(sing)
te	te	adp()
worden	worden	V(infin)
quijt	kwijt	adj()
die	die	Pron(rel)
uyt	uit	Adp()
hollandt	holland	N(prop)
over	over	Adp()
lanck	lang	adj()
scheyde	scheiden	N(sing)
met	met	Adp()
een	een	Art(indef)
vuyle	vuil	n(sing)
stanck	stank	N(sing)
edel	edel	adj()
vlaemsche	vlaams	Adj()
nederlanders	nederlander	N(prop)
nu	nu	Adv(dem)
eens	eens	Adv(gener)
uyt	uit	Adp()
u	gij	Pron(poss)
oogen	oog	N(plu)
ziet	zien	V(imp)
stuert	storten	V(fin,pres,lex)
de	de	Art(def)
helsche	hels	adj()
stokebranders	zulkerhande	N(plu)
nae	na	Adp()
pluto	plato	N(sing)
door	door	Adp()
lethus	leeg	N(sing)
vliet	vlieden	V(imp)
benje	benemen	V(fin,pres,aux_cop)
wijs	wijs	Adj()
wort	worden	V(fin,pres,aux_cop)
prins	prins	n(sing)
of	of	Conj(coord)
frans	frans	N(sing)
wijckt	wijken	V(fin,pres,lex)
het	het	pron(pers,3,sing)
heerschen	heersen	V(infin)
des	de	Art(def)
tyrans	tiran	N(sing)
princelycke	prinselijk	N(sing)
brave	braam	n(sing)
geesten	geeste	v(infin)
ackordeert	accorderen	v(participle,past)
met	met	adp()
onsen	ons	Pron(poss)
prins	prins	N(sing)
schuylt	schuilen	V(fin,pres,lex)
voor	voor	Adp()
d	de	Art(def)
'	?	punc(quest)
oude	oud	Adj()
dwanghs	dwingen	n(sing)
tempeesten	tapijt	n(sing)
ondert	het+onder	V(imp)
hooft	hoofd	n(sing)
van	van	Adp()
ons	wij	Pron(pers,1,plu)
provins	profijt	n(sing)
die	die	Pron(rel)
zijn	zijn	V(fin,pres,aux_cop)
ondersaten	onderzaat	N(plu)
gou	goud	N(sing)
vooren	voren	Adv(gener)
staat	staan	N(sing)
in	in	Adp()
liefd	liefde	N(sing)
ghetrou	getrouw	N(sing)
weest	zijn	V(imp)
voorsichtigh	voorzichtig	Adj()
