staet	staan	v(fin,pres,lex)
op	op	Adp()
ontwaeckt	onbevlekt	V(fin,pres,lex)
nu	nu	Adv(dem)
al	al	Adv(gener)
ghemeyn	gemeen	Adj()
ghy	gij	Pron(pers,2,plu)
die	die	Pron(rel)
daer	daar	Adv(dem)
slaept	slapen	v(fin,pres,lex)
in	in	adp()
sonden	zonde	n(plu)
onreyn	onrein	adj()
laet	laten	V(imp)
u	gij	Pron(pers,2,plu)
van	van	adp()
gods	god	N(sing)
woort	woord	N(sing)
leeren	leren	V(infin)
tot	tot	Adp()
christum	christus	N(prop)
wilt	willen	V(fin,pres,aux_cop)
u	gij	Pron(pers,2,sing)
bekeeren	bekeren	V(infin)
in	in	Adp()
desen	deze	pron(dem)
aenghenamen	aangenaam	adj()
tijt	tijd	n(sing)
wilt	willen	V(fin,pres,aux_cop)
u	gij	Pron(pers,2,sing)
bekeeren	bekeren	V(infin)
sonder	zonder	Adp()
respijt	respijt	N(sing)
den	de	art(def)
dach	dag	n(sing)
is	zijn	v(fin,pres,aux_cop)
opgheresen	oprijzen	V(participle,past)
des	de	art(def)
salicheyts	zaligheid+is	N(sing)
ghepresen	prijzen	V(participle,past)
luystert	luisteren	N(sing)
en	en	Conj(coord)
hoort	horen	V(imp)
na	na	Adp()
sheeren	de+heer	Adp()+Art(def)+N(sing)
woort	woord	N(sing)
twelck	hetwelk	Pron(rel)
uwer	uw	Pron(poss)
sielen	ziel	N(sing)
mach	mogen	v(fin,pres,aux_cop)
gheven	geven	v(infin)
confoort	comfort	N(sing)
wilt	willen	V(fin,pres,aux_cop)
ghy	gij	Pron(pers,2,plu)
de	de	Art(def)
straffe	straffen	N(sing)
ontvlieden	ontvlieden	v(infin)
diemen	die+men	Pron(rel)+Pron(indef)
corts	korts	Adv(gener)
sal	zullen	V(fin,pres,aux_cop)
sien	zien	V(infin)
gheschieden	geschieden	V(infin)
vliet	vlieden	V(imp)
uut	uit	Adp()
egypten	egypte	n(prop)
en	en	Conj(coord)
babel	babel	N(prop)
rasch	ras	Adj()
en	en	Conj(coord)
wilt	willen	V(fin,pres,aux_cop)
aentrecken	aantrekken	V(infin)
sheeren	de+heer	Adj()+Art(def)+N(sing)
harnasch	harnas	N(sing)
om	om	adp()
vromelick	vromelijk	adv(gener)
te	te	Adp()
strijden	strijden	v(infin)
in	in	adp()
dese	deze	Pron(dem)
boose	boos	Adj()
tijden	tijd	N(plu)
anders	anders	Adv(gener)
sult	zullen	V(fin,pres,aux_cop)
ghy	gij	Pron(pers,2,plu)
verloren	verliezen	V(participle,past)
gaen	gaan	V(infin)
en	en	Conj(coord)
loon	loon	N(sing)
naer	naar	Adp()
uwe	uw	Pron(poss)
wercken	werk	N(plu)
ontfaen	ontvangen	v(participle,past)
wort	worden	V(fin,pres,aux_cop)
ghy	gij	Pron(pers,2,plu)
deelachtich	deelachtig	Adj()
ghevonden	vinden	V(participle,past)
in	in	Adp()
de	de	art(def)
babyloonsche	babylonisch	Adj()
sonden	zonde	N(plu)
nu	nu	Adv(dem)
is	zijn	v(fin,pres,aux_cop)
den	de	art(def)
dach	dag	n(sing)
des	de	Art(def)
heeren	heer	N(sing)
naer	naar	Adp()
o	o	Interj()
menschen	mens	N(plu)
hebt	hebben	V(fin,pres,aux_cop)
ghy	gij	Pron(pers,2,plu)
noch	noch	Adv(gener)
gheenen	geen	Pron(indef)
vaer	vaar	N(sing)
het	het	Art(def)
sweert	zwaard	N(sing)
wort	worden	V(fin,pres,aux_cop)
bloedich	bloedig	Adj()
bevonden	bevinden	V(participle,past)
over	over	adp()
de	de	Art(def)
babyloonsche	babylonische	Adj()
honden	hond	N(plu)
vreeset	vrezen	V(fin,pres,lex)
den	de	Art(def)
heere	heer	N(sing)
al	al	Adv(gener)
ghemeen	gemeen	Adv(gener)
oft	of	Conj(coord)
u	gij	Pron(pers,2,sing)
naect	naakt	V(fin,pres,lex)
druck	druk	N(sing)
en	en	Conj(coord)
groot	groot	Adj()
gheween	geween	Adj()
en	en	Conj(coord)
knerssinghe	knarsing	N(sing)
der	de	art(def)
tanden	tand	n(plu)
ghebonden	binden	v(participle,past)
met	met	Adp()
helsche	hels	adj()
banden	band	N(plu)
schuwet	schuwen	v(fin,pres,lex)
de	de	art(def)
werelt	wereld	n(sing)
en	ne	adv(neg)
cruycet	kruisen	v(fin,pres,lex)
vleesch	vlees	N(sing)
en	en	Conj(coord)
levet	leven	v(fin,pres,lex)
na	na	adp()
der	de	art(def)
schriftueren	schriftuur	N(plu)
heesch	hees	Adj()
laet	laten	V(imp)
menschen	mens	N(plu)
leeringhe	lering	n(sing)
varen	varen	v(infin)
gods	god	N(sing)
woort	woord	N(sing)
wilt	willen	V(fin,pres,aux_cop)
wel	wel	Adv(gener)
bewaren	bewaren	V(infin)
