fy	fij	Adj()
babel	babel	N(prop)
quaet	kwaad	N(sing)
met	met	Adp()
uwen	uw	Pron(poss)
roomschen	roomse	N(plu)
godt	god	N(sing)
ghy	gij	Pron(pers,2,sing)
gheeft	geven	V(fin,pres,lex)
aflaet	aflaat	N(sing)
door	door	Adp()
u	gij	Pron(poss)
onwijs	onwijs	N(sing)
gebodt	gebod	N(sing)
fy	fij	adj()
hoer	haar	pron(poss)
onteert	onteren	v(fin,pres,lex)
die	die	pron(rel)
met	met	Adp()
t	het	Art(def)
'	?	punc(quest)
veelhoofdich	???	Adj()
dier	dier	n(sing)
hebt	hebben	v(fin,pres,aux_cop)
geboeleert	boeleren	v(participle,past)
int	in+het	adp()+art(def)
ontuutbluslijck	onuitbluslijk	N(sing)
vier	vuur	N(sing)
u	uw	Pron(poss)
cardinaels	kardinalen	N(sing)
en	en	Conj(coord)
bisschoppen	bisschoppen	V(infin)
vileyn	vilein	adj()
boeleren	boeleren	v(infin)
smaels	maal	n(sing)
met	met	Adp()
u	gij	Pron(pers,2,sing)
o	o	interj()
hoer	haar	pron(poss)
onreyn	onrein	adj()
wie	wie	pron(inter)
sondich	zondig	Adj()
is	zijn	V(fin,pres,aux_cop)
van	van	Adp()
uwe	uw	pron(poss)
broerkens	broer	N(plu)
al	al	Adv(gener)
gheeft	geven	V(fin,pres,lex)
ghy	gij	Pron(pers,2,plu)
remis	remis	N(sing)
om	om	Adp()
comen	komen	v(infin)
niet	niet	adv(neg)
ten	te+de	Adp()+Art(def)
val	val	n(sing)
dit	dit	Pron(dem)
paeps	paaps	N(sing)
gespuys	gespuis	N(sing)
meest	meest	Adv(gener)
leven	leven	V(infin)
na	na	Adp()
haer	haar	Pron(poss)
wil	wil	n(sing)
want	want	conj(coord)
selfs	zelf	pron(dem)
abuys	abuis	n(prop)
hebben	hebben	V(fin,pres,aux_cop)
sy	zij	Pron(pers,3,plu)
en	en	Adv(neg)
verschil	verschil	N(sing)
van	van	adp()
ordening	ordening	n(sing)
en	een	art(indef)
nonnen	non	N(plu)
cloosters	klooster	n(prop)
veel	veel	num(indef)
de	de	Art(def)
handeling	handeling	n(sing)
van	van	adp()
dien	die	pron(dem)
is	zijn	v(fin,pres,aux_cop)
ondeuchts	ondeugd	adj()
deel	deel	n(sing)
de	de	art(def)
jesuwyts	jezuieten	N(prop)
willen	willen	V(fin,pres,aux_cop)
de	de	art(def)
beste	best	Adj()
zijn	zijn	V(fin,pres,aux_cop)
doch	doch	Adv(gener)
ypocryts	hypocriet	Adj()
zijnt	zijn	V(fin,pres,lex)+Pron(pers,3,sing)
in	in	adp()
beveynsde	beveinsd	adj()
schijn	schijn	n(sing)
de	de	art(def)
capucijns	capucijns	n(sing)
gelijken	gelijk	V(infin)
t	het	Art(def)
'	?	punc(quest)
heylich	heilig	Adj()
vat	vat	n(sing)
onnutte	onnut	adj()
zwijns	zwijn	N(sing)
zijnse	zijn+zij	V(fin,pres,aux_cop)+Pron(pers,3,plu)
verstaet	verstaan	V(imp)
wel	wel	adv(gener)
dat	dat	conj(subord)
de	de	art(def)
minnebroers	minnebroers	N(prop)
hun	zij	Pron(pers,3,plu)
handeling	handeling	N(sing)
is	zijn	V(fin,pres,aux_cop)
snoo	snood	Adj
doortrapte	doortrappen	Adj()
loers	loeder	N(sing)
en	ne	adv(neg)
bidden	bidden	V(infin)
broot	brood	N(sing)
om	om	Adp()
goo	god	N(sing)
vrouwebroers	vrouwebroers	N(sing)
en	en	Conj(coord)
preeckaren	prediker	V(infin)
int	in+het	Adp()+Art(def)
gemeen	gemeen	n(sing)
na	na	Adp()
t	het	Art(def)
'	?	punc(quest)
recht	recht	N(sing)
beken	beek	v(infin)
van	van	Adp()
al	al	Num(indef)
en	ne	adv(neg)
deughter	deugd+er	N(sing)+Adv()
geen	geen	pron(indef)
koordekens	koordeken	N(plu)
mee	mee	Adv(gener)
dwelck	de+welke	Art(def)+Pron(rel)
souden	zullen	v(fin,past,aux_cop)
tegen	tegen	Adp()
staen	staan	v(infin)
tquaet	het+kwaad	Art(def)+N(sing)
datmen	dat+men	Conj(subord)+Pron(indef)
dee	de	Art(def)
die	de	Pron(rel)
stellent	stellen+het	V(inf)+Art(def)
oock	ook	Adv(gener)
soo	zo	Adv(resum)
aen	aan	Adp()
als	als	Conj(comp)
proosten	proost	N(sing)
doen	doen	V(infin)
en	en	Conj(coord)
oock	ook	Adv(gener)
prioren	prior	N(plu)
erch	erg	N(sing)
die	die	Pron(rel)
door	door	Adp()
gewoen	gewoon	Adj()
wel	wel	Adv(gener)
gaen	gaan	v(infin)
inde	en	conj(coord)
herberch	herberg	N(sing)
ghy	gij	Pron(pers,2,plu)
menschen	mens	N(plu)
blint	blind	Adj()
gelooft	geloven	v(participle,past)
niet	niet	Adv(neg)
sulcke	zulk	Pron(dem)
lien	lijden	V(infin)
die	de	Pron(rel)
onbesint	onbezinnig	Adj()
haer	haar	pron(poss)
eygen	eigen	adj()
quaet	kwaad	n(sing)
niet	niet	adv(neg)
sien	zien	V(infin)
blyfdy	blijven+jij	V(fin,pres,lex)+Pron(pers,2,sing)
versteent	verstenen	v(participle,past)
is	zijn	V(fin,pres,aux_cop)
u	gij	Pron(poss)
verstant	verstand	N(sing)
onvroet	onvroed	Adj()
mits	mits	Conj(coord)
ghy	gij	Pron(pers,2,plu)
nu	nu	Adv(dem)
meent	menen	V(fin,pres,lex)
dat	dat	Conj(subord)
t	het	Art(def)
'	?	punc(quest)
hout	houden	N(sing)
mirakel	mirakel	n(sing)
doet	doen	V(fin,pres,lex)
elck	elk	Pron(indef)
clooster	klooster	N(sing)
mach	mogen	V(fin,pres,aux_cop)
wel	wel	adv(gener)
heeten	heten	v(infin)
een	een	art(indef)
moortkuyl	moordkuil	N(sing)
het	het	Pron(pers,3,sing)
boos	boos	Adj()
gewach	gewag	N(sing)
haerselven	haarzelf	Pron(refl,3,sing)
maecht	mogen	V(fin,pres,lex)
heel	heel	n(sing)
vuyl	vuil	N(sing)
om	om	Adp()
dat	dat	Pron(dem)
sulck	zulk	Pron(dem)
soch	zog	N(sing)
is	zijn	V(fin,pres,aux_cop)
vande	van+de	Adp()+Art(def)
hoer	haar	pron(poss)
gesoocht	zogen	v(participle,past)
te	te	adp()
babel	babel	N(prop)
doch	doch	Adv(gener)
dat	dat	Conj(subord)
god	god	n(sing)
niet	niet	adv(neg)
meer	meer	num(indef)
gedoocht	dogen	V(participle,past)
u	gij	Pron(poss)
oogen	oog	N(plu)
dan	dan	Conj(comp)
wilt	willen	V(fin,pres,aux_cop)
open	open	Adj()
doen	doen	V(infin)
en	en	Conj(coord)
siet	zien	v(fin,pres,lex)
dat	dat	Conj(subord)
ghy	gij	Pron(pers,2,sing)
hier	hier	Adv(dem)
van	van	Adp()
u	gij	Pron(pers,2,sing)
wacht	wachten	V(fin,pres,lex)
en	en	Conj(coord)
van	van	Adp()
haer	haar	Pron(poss)
vliet	vlieden	v(fin,pres,lex)
caims	ka√Øn	N(prop)
ghebroet	broeden	V(participle,past)
haer	haar	Pron(poss)
logens	leugen	n(sing)
niet	niet	Adv(neg)
aenhoort	aanhoren	V(imp)
het	het	Art(def)
paepsche	paaps	N(sing)
bloet	bloed	N(sing)
doocht	dogen	V(fin,pres,lex)
niet	niet	Adv(neg)
al	al	Adv(gener)
de	de	art(def)
konsoort	konsoort	N(sing)
