den	de	Art(def)
paus	paus	N(sing)
is	zijn	V(fin,pres,aux_cop)
onsen	ons	pron(poss)
vader	vader	N(sing)
hy	hij	Pron(pers,3,sing)
is	zijn	V(fin,pres,aux_cop)
van	van	Adp()
god	god	N(sing)
vercoren	verkiezen	V(participle,past)
hy	hij	Pron(pers,3,sing)
verlost	verlossen	V(fin,pres,lex)
ons	wij	Pron(pers,1,plu)
allegader	algader	Num(indef)
niemant	niemand	Pron(indef)
en	ne	Adv(neg)
blijft	blijven	V(fin,pres,lex)
verloren	verliezen	V(participle,past)
dus	dus	Adv(dem)
wilt	willen	V(fin,pres,aux_cop)
vry	vrij	Adj()
vreucht	vreugde	N(sing)
orboren	orbaren	V(infin)
ghy	gij	Pron(pers,2,plu)
menschen	mens	N(plu)
onvertsaecht	onversaagd	Adj()
de	de	Art(def)
hel	hel	N(sing)
sal	zullen	V(fin,pres,aux_cop)
hy	hij	Pron(pers,3,sing)
verstoren	verstoren	V(infin)
somen	zo+men	Pron(resum)+Pron(indef)
de	de	Art(def)
spiessen	spies	N(plu)
draecht	dragen	V(fin,pres,lex)
hy	hij	Pron(pers,3,sing)
heeft	hebben	V(fin,pres,aux_cop)
seer	zeer	Adv(gener)
veelderhande	velerhande	adj()
so	zo	Adv(resum)
monicken	monnik	n(plu)
ende	en	conj(coord)
papen	paap	N(plu)
zy	zij	Pron(pers,3,plu)
hebben	hebben	V(fin,pres,aux_cop)
kleyn	klein	Adj()
provande	proviand	N(sing)
om	om	Adp()
niet	niet	Adv(neg)
zy	zij	Pron(pers,3,plu)
singhen	zingen	V(infin)
en	en	Conj(coord)
gapen	gapen	V(fin,pres,lex)
alleen	alleen	Adv(gener)
sy	zij	Pron(pers,3,plu)
altoos	altoos	Adv(gener)
slapen	slapen	V(infin)
soo	zo	Adv(resum)
lang	lang	Adv(gener)
tot	tot	Adp()
dattet	dat+het	conj(subord)+pron(pers,3,sing)
daecht	dagen	n(sing)
haer	haar	pron(poss)
wercken	werk	N(plu)
zijn	zijn	V(fin,pres,aux_cop)
van	van	Adp()
god	god	N(sing)
gheschapen	scheppen	V(participle,past)
soomen	zo+men	Pron(resum)+Pron(indef)
de	de	Art(def)
spiessen	spies	N(plu)
draecht	dragen	V(fin,pres,lex)
zy	zij	Pron(pers,3,sing)
soecken	zoeken	V(fin,pres,lex)
geen	geen	Pron(indef)
duccaten	dukaat	N(plu)
goutguldens	goudgulden	N(plu)
ofte	of	conj(coord)
croonen	kroon	N(plu)
zy	zij	Pron(pers,3,sing)
drincken	drinken	V(infin)
al	al	Adv(gener)
by	bij	Adp()
maten	maat	N(sing)
en	en	Conj(coord)
eten	eten	v(fin,pres,lex)
rouwe	rouw	n(sing)
boonen	boon	v(fin,pres,lex)
ic	ik	pron(pers,1,sing)
moetse	moeten+zij	V(fin,pres,aux_cop)+Pron(pers,3,plu)
wat	wat	pron(inter)
verschoonen	verschonen	V(infin)
my	ik	Pron(pers,1,sing)
isser	zijn+er	V(fin,pres,lex)+Pron(pers,3,sing)
nae	na	Adp()
ghevraecht	vragen	V(participle,past)
den	de	Art(def)
heere	heer	N(sing)
salt	zullen+het	V(fin,pres,aux_cop)
hun	zij	Pron(pers,3,plu)
loonen	lonen	V(infin)
somen	zo+men	Pron(resum)+Pron(indef)
de	de	Art(def)
spiessen	spies	N(plu)
draecht	dragen	V(fin,pres,lex)
zy	zij	Pron(pers,3,sing)
hebben	hebben	V(fin,pres,aux_cop)
geen	geen	Pron(indef)
dominien	dominie	n(sing)
hier	hier	Adv(dem)
noch	noch	adv(gener)
in	in	Adp()
geene	geen	pron(indef)
plecken	plek	N(plu)
zy	zij	Pron(pers,3,sing)
zijn	zijn	V(fin,pres,aux_cop)
goet	goed	N(sing)
van	van	Adp()
opinien	opinie	N(plu)
hun	zij	Pron(pers,3,plu)
schanden	schande	N(sing)
sy	zij	Pron(pers,3,plu)
bedecken	bedekken	V(infin)
hoort	horen	V(imp)
my	ik	Pron(pers,1,sing)
haer	haar	Pron(poss)
deucht	deugd	N(sing)
verwecken	verwekken	V(infin)
die	de	Pron(rel)
geenich	geenig	adj()
dinc	ding	n(plu)
mishaecht	mishagen	V(fin,pres,lex)
oock	ook	Adv(gener)
zijnse	zijn+zij	V(fin,pres,aux_cop)+Pron(pers,3,plu)
sonder	zonder	Adp()
vlecken	vlek	N(plu)
somen	som	Pron(resum)+Pron(indef)
de	de	Art(def)
spiessen	spies	N(plu)
draecht	dragen	V(fin,pres,lex)
prince	prins	N(sing)
prince	prins	N(sing)
ghy	gij	Pron(pers,2,plu)
sasserdoten	sacerdoot	V(fin,past,lex)
wilt	willen	V(fin,pres,aux_cop)
bet	bet	Adv(gener)
u	gij	pron(pers,2,sing)
eer	eer	conj(subord)
bewaren	bewaren	V(infin)
ghy	gij	Pron(pers,2,plu)
zijt	zijn	V(fin,pres,aux_cop)
van	van	Adp()
gods	god	N(sing)
genoten	genoot	n(sing)
die	die	Pron(rel)
wil	willen	V(fin,pres,aux_cop)
u	gij	Pron(pers,2,sing)
langhe	lang	Adv(gener)
sparen	sparen	V(infin)
met	met	adp()
allen	al	num(indef)
u	gij	Pron(poss)
dienaren	dienaar	N(plu)
de	de	Art(def)
schriftuer	schriftuur	N(sing)
ghy	gij	Pron(pers,2,plu)
deurknaecht	deurknecht	N(sing)
godts	god	N(sing)
woordt	woord	N(sing)
saldy	zullen+gij	V(fin,pres,aux_cop)+Pron(pers,2,plu)
verclaren	verklaren	v(infin)
soomen	zo+men	Pron(resum)+Pron(indef)
de	de	Art(def)
spiessen	spies	N(plu)
draecht	dragen	V(fin,pres,lex)
