wat	wat	Pron(inter)
heyl	heil	n(sing)
wat	wat	Pron(inter)
zegeningen	rekening	n(sing)
o	o	Interj()
edel	edel	Adj()
vorst	vorst	N(sing)
nassouw	nassau	N(prop)
en	en	Conj(coord)
wat	wat	Pron(inter)
veroveringhen	verwerping	V(infin)
tot	tot	Adp()
spangjens	spanje	N(prop)
smart	smart	N(sing)
en	en	Conj(coord)
rou	rauw	N(sing)
geeft	geven	V(fin,pres,lex)
ghy	gij	Pron(pers,2,plu)
ons	wij	Pron(pers,1,plu)
tot	tot	Adp()
u	gij	Pron(poss)
glory	glorie	N(sing)
met	met	Adp()
victory	victorie	N(sing)
het	het	Pron(pers,3,sing)
fort	voort	N(sing)
dat	dat	pron(dem)
is	zijn	v(fin,pres,aux_cop)
bedwonghen	bedwingen	v(participle,past)
dat	dat	conj(subord)
vlaendrens	vlaanderen	n(plu)
sleutel	sleutel	n(sing)
was	zijn	v(fin,past,aux_cop)
de	de	Art(def)
deur	door	Adp()
is	zijn	V(fin,pres,aux_cop)
op	op	Adp()
ghespronghen	springen	v(participle,past)
van	van	adp()
'	?	punc(quest)
t	het	Art(def)
alder	al+de	Num(indef)+Art(def)
stercktste	sterkheid	Adj()
sas	zijn	Adv()
dat	dat	pron(dem)
doet	doen	v(fin,pres,lex)
de	de	art(def)
gentenaren	gente	N(plu)
vry	vrij	Adj()
beswaren	bezwaren	V(infin)
nu	nu	Adv(dem)
sucht	zuchten	V(fin,pres,lex)
het	het	Art(def)
groote	groot	Adj()
spangjen	spanje	N(plu)
om	om	Adp()
syne	zijn	pron(poss)
vastigheydt	opstijgen	N(sing)
by	bij	adp()
onsen	ons	Pron(poss)
vorst	vorst	N(sing)
orangjen	oranje	N(prop)
zoo	zo	Adv(resum)
moedich	moedig	Adj()
neer	neer	Adv(gener)
gheleydt	leiden	V(participle,past)
hy	hij	Pron(pers,3,sing)
kan	kunnen	V(fin,pres,aux_cop)
op	op	Adp()
gheen	geen	Pron(indef)
ghebouwen	gebeuren	N(sing)
meer	meer	Num(indef)
betrouwen	betrouwen	V(infin)
geen	geen	Pron(indef)
stoute	stout	adj()
water	water	n(sing)
stromen	stroom	v(infin)
noch	noch	conj(coord)
schanssen	schans	N(plu)
op	op	adp()
haer	haar	Pron(poss)
kant	kant	N(sing)
belet	beletten	V(participle,past)
den	de	Art(def)
heldt	held	N(sing)
te	te	Adp()
komen	komen	v(infin)
int	in+het	Adp()+Art(def)
rijcke	rijk	N(sing)
vlaenderlandt	vlaanderland	N(plu)
daer	daar	Adv(dem)
hy	hij	Pron(pers,3,sing)
nu	nu	Adv(dem)
syn	zijn	Pron(poss)
banieren	banier	N(plu)
stout	stout	adj()
doet	doen	n(sing)
swieren	zweren	V(infin)
slaet	slaan	v(fin,pres,lex)
tromlen	???	V(infin)
en	en	Conj(coord)
trompetten	trompet	N(plu)
'	?	punc(quest)
t	het	Art(def)
canon	canon	N(prop)
hoe	hoe	Adv(inter)
wreet	wreed	Adj()
en	een	Conj(coord)
fel	fel	Adj()
de	de	Art(def)
dood	dood	N(sing)
'	?	punc(quest)
lycke	lokken	n(sing)
musquetten	muskaat	N(sing)
het	het	pron(pers,3,sing)
dulle	dul	adj()
oorloghs	oorlog	n(sing)
spel	spel	n(sing)
laet	laten	V(imp)
al	al	Adv(gener)
tot	tot	Adp()
vreuchden	vreugde	N(sing)
dondren	donder	N(plu)
met	met	adp()
verwondren	verwonderen	N(sing)
doet	dood	n(sing)
vreugden	vreugde	v(infin)
vieren	vieren	V(infin)
branden	branden	N(plu)
victory	victorie	N(sing)
geeft	geven	V(fin,pres,lex)
ons	wij	Pron(poss)
stoff	stof	N(sing)
om	om	Adp()
heyl	heil	n(sing)
'	?	punc(quest)
ghe	geen	Pron(pers,2,plu)
offerhanden	offerande	n(plu)
te	te	adp()
storten	storten	V(infin)
tot	tot	adp()
gods	god	N(sing)
loff	lof	N(sing)
en	en	Conj(coord)
synen	zijn	Pron(poss)
naem	naam	N(sing)
bescheyden	bescheiden	V(infin)
uut	uit	Adp()
te	te	adp()
breyden	breiden	V(infin)
dees	deze	Pron(dem)
gloryrijcken	glorificeren	Adj()
zeeghen	zegen	V(infin)
door	door	Adp()
gods	god	N(sing)
ghenaed	genade	N(sing)
'	?	punc(quest)
en	en	Conj(coord)
handt	hand	N(sing)
by	bij	Adp()
onsen	ons	Pron(poss)
vorst	vorst	N(sing)
verkreeghen	verkrijgen	v(infin)
tot	tot	Adp()
heyl	heil	N(sing)
vant	van+het	Adp()+Art(def)
vaderlandt	vaderland	N(sing)
viert	vieren	N(sing)
nu	nu	Adv(dem)
met	met	Adp()
danckbaerheden	dankbaarheid	N(sing)
alle	al	num(indef)
steden	stad	n(plu)
die	die	pron(rel)
in	in	Adp()
het	het	pron(pers,3,sing)
harnas	harnas	N(sing)
flonckert	blonk	N(sing)
en	en	Conj(coord)
door	door	Adp()
u	gij	Pron(poss)
blicxum	blik	N(sing)
glans	glans	N(sing)
des	de	art(def)
vyandts	vijand	N(sing)
son	zon	n(sing)
verdonckert	verdonkeren	V(fin,pres,lex)
wat	wat	pron(inter)
waerde	woord	n(plu)
eer	eer	conj(subord)
of	of	conj(coord)
krans	krans	n(sing)
salt	zullen+het	v(fin,pres,aux_cop)
hollandts	holland	N(prop)
volck	volk	N(sing)
nu	nu	Adv(dem)
toonen	tonen	V(infin)
u	gij	Pron(pers,2,sing)
te	te	Adp()
kroonen	kroon	v(infin)
wij	wij	pron(pers,1,plu)
sullen	zullen	v(fin,pres,aux_cop)
gaen	gaan	v(infin)
uyt	uit	Adp()
galmen	palm	N(plu)
ontsachelijck	ontzichlijk	Adj()
vorst	vorst	N(sing)
met	met	Adp()
loffsangh	lofzang	N(sing)
en	en	Conj(coord)
met	met	Adp()
psalmen	psalm	N(plu)
en	en	Conj(coord)
u	gij	Pron(pers,2,sing)
verheven	verheffen	v(participle,past)
borst	borst	N(sing)
zijn	zijn	v(fin,pres,aux_cop)
daden	doen	N(plu)
eeuwich	eeuwig	Adj()
prijsen	prijzen	V(infin)
danck	dank	N(sing)
bewijsen	bewijzen	V(infin)
en	een	Conj(coord)
godes	god	n(sing)
gonst	gunst	N(sing)
afsmeecken	afwijken	v(infin)
dat	dat	conj(subord)
vorstelycke	vorstelijk	adv(gener)
zaet	zaad	n(sing)
ons	wij	pron(pers,1,plu)
nimmer	nimmer	n(sing)
mach	mogen	v(fin,pres,aux_cop)
ghebreken	gebreken	v(infin)
tot	tot	Adp()
voordeel	voordeel	N(sing)
van	van	adp()
ons	wij	pron(pers,1,plu)
staet	staan	v(fin,pres,lex)
diens	diens	Pron(dem)
trou	trouw	N(sing)
aen	aan	Adp()
alien	vlieden	Adv(gener)
wijcken	wijk	V(infin)
ons	wij	Pron(poss)
moet	moeten	V(fin,pres,aux_cop)
blijcken	blijken	V(infin)
arbeyt	arbeid	n(sing)
om	om	Adp()
rust	rust	n(sing)
