aurora	aurora	n(prop)
die	de	Pron(rel)
verlicht	verlichten	V(fin,pres,lex)
t	het	Art(def)
'	?	punc(quest)
firmament	firmament	N(sing)
doet	doen	v(fin,pres,lex)
nu	nu	adv(dem)
der	de	art(def)
manen	maan	n(sing)
haer	haar	pron(poss)
schijnen	schijnen	v(infin)
laten	laten	V(infin)
de	de	Art(def)
sterren	ster	N(plu)
aen	aan	Adp()
t	het	Art(def)
'	?	punc(quest)
hemels	hemel	N(sing)
troone	troon	N(sing)
gheprent	prenten	V(participle,past)
nemen	nemen	v(infin)
de	de	Art(def)
claerheyt	klaarheid	n(sing)
des	de	Art(def)
daeghs	dag	N(sing)
te	te	adp()
baten	baat	n(sing)
daer	daar	adv(rel)
de	de	art(def)
bloemkens	bloem	n(plu)
haren	haar	pron(poss)
dau	dauw	n(sing)
by	bij	Adp()
vaten	vat	N(plu)
staet	staan	V(imp)
op	op	Adp()
staet	staan	v(fin,pres,lex)
op	op	adp()
tes	het+zijn	Pron(pers,3,sing)+V(fin,pres,aux_cop)
schoon	schoon	adj()
dach	dag	n(sing)
die	die	Pron(rel)
in	in	adp()
liefs	lief	adj()
armkens	arm	n(sing)
ligghen	liggen	v(infin)
met	met	adp()
vreughden	vreugde	N(sing)
bidt	bidden	v(imp)
veneri	venerie	n(sing)
dat	dat	conj(subord)
noch	nog	adv(gener)
ghebeuren	gebeuren	v(infin)
mach	mogen	v(fin,pres,aux_cop)
neempt	nemen	V(imp)
orloff	oorlof	n(sing)
aen	aan	Adp()
de	de	art(def)
soete	zoet	Adj()
jeughden	jeugd	V(fin,past,lex)
soo	zo	Adv(resum)
blijfdy	blijven+gij	V(fin,past,lex)+Pron(pers,2,plu)
in	in	Adp()
eeren	eer	N(sing)
en	en	Conj(coord)
in	in	Adp()
deughden	deugd	N(plu)
ontweckt	ontwekken	V(imp)
ghy	gij	Pron(pers,2,plu)
amoreuse	amoreus	N(sing)
sinnen	zin	N(plu)
ontweckt	ontwekken	V(imp)
uus	uw	Pron(poss)
slaeps	slaap	N(sing)
tis	het+zijn	Pron(pers,3,sing)+V(fin,pres,aux_cop)
meer	meer	Num(indef)
dan	dan	Conj(comp)
tijt	tijd	n(sing)
wildy	willen+gij	V(fin,pres,aux_cop)+Pron(pers,2,plu)
de	de	art(def)
rooskens	roos	N(plu)
plucken	plukken	n(plu)
van	van	adp()
minnen	minne	n(sing)
siet	zien	v(fin,pres,lex)
dat	dat	Conj(subord)
ghy	gij	Pron(pers,2,sing)
onder	onder	Adp()
die	de	Art(def)
blomkens	bloem	N(plu)
zijt	zijn	v(fin,pres,aux_cop)
daer	daar	Adv(dem)
de	de	Art(def)
voghelkens	vogel	N(plu)
baren	baren	N(plu)
jolijt	jolijt	n(prop)
die	de	Pron(rel)
blomkens	bloem	n(plu)
met	met	adp()
soeten	zoet	adj()
douwe	dauw	n(sing)
behanghen	behangen	V(infin)
die	die	pron(rel)
sullen	zullen	v(fin,pres,aux_cop)
u	gij	pron(pers,2,sing)
alle	al	num(indef)
soetheyt	zoetheid	N(sing)
gheven	geven	v(infin)
laet	laten	V(imp)
blosen	blozen	V(infin)
die	de	art(def)
lieffelijcke	lieflijk	adj()
wanghen	wang	N(plu)
en	en	Conj(coord)
de	de	Art(def)
herten	hart	N(sing)
d	de	Art(def)
'	?	punc(quest)
een	een	Art(indef)
aen	aan	Adp()
d	de	Art(def)
'	?	punc(quest)
ander	ander	Adj()
beven	beven	V(infin)
soo	zo	Adv(resum)
macher	mogen+er	V(fin,pres,aux_cop)+Pron(indef)
alle	al	Num(indef)
vreught	vreugde	N(sing)
aencleven	aankleven	v(infin)
