wy	wij	Pron(pers,1,plu)
hebben	hebben	v(fin,pres,aux_cop)
ein	een	art(indef)
stercke	sterk	adj()
stadt	stad	n(sing)
loopt	lopen	V(fin,pres,lex)
rat	rad	N(sing)
die	die	Pron(rel)
ons	wij	pron(pers,1,plu)
in	in	adp()
alder	al+de	Num(indef)+Art(def)
duecht	deugd	n(sing)
verhuecht	verheugen	V(fin,pres,lex)
oprecht	oprecht	v(fin,pres,lex)
in	in	Adp()
vreden	vrede	N(sing)
is	zijn	v(fin,pres,aux_cop)
haren	haar	pron(poss)
pat	pad	n(sing)
daer	daar	adv(dem)
in	in	adp()
so	zo	adv(resum)
hebt	hebben	v(fin,pres,aux_cop)
u	gij	pron(poss)
vruecht	vreugde	N(sing)
godts	god	N(sing)
verstandt	verstand	N(sing)
is	zijn	V(fin,pres,aux_cop)
sy	zij	Pron(pers,3,plu)
genamt	genaamd	Adj()
befaemt	befaamd	v(fin,pres,lex)
mit	met	adp()
trow	trouw	n(sing)
und	en	adp()
waerheit	waarheid	n(sing)
stolt	stout	adj()
gebout	gebod	n(sing)
daer	daar	Adv(dem)
is	zijn	V(fin,pres,aux_cop)
reyn	rein	Adj()
lieffde	liefde	N(sing)
als	als	Conj(comp)
idt	hebben	adv(gener)
betaemt	betamen	V(fin,pres,lex)
godts	god	N(sing)
geest	geest	N(sing)
daer	daar	Adv(dem)
nicht	nicht	n(sing)
en	en	art(indef)
flout	bloot	N(sing)
tvry	toren	N(sing)
gemt	gaan	v(fin,pres,lex)
des	dat	pron(dem)
waren	zijn	v(fin,past,aux_cop)
geest	geest	n(sing)
verstt	verst	v(fin,pres,lex)
den	de	art(def)
leest	lezen	n(sing)
dat	dat	conj(subord)
syn	zijn	v(fin,pres,aux_cop)
haer	haar	pron(poss)
mueren	muur	n(plu)
die	de	art(def)
ewich	eeuwig	adj()
dueren	duren	v(infin)
daer	daar	pronadv(rel)
alle	al	num(indef)
gewalt	geweld	n(sing)
mit	met	adp()
syn	zijn	pron(poss)
tempeest	tempeest	n(sing)
haer	haar	Pron(poss)
tegenspuet	tegenspoed	N(sing)
besueren	bezuren	V(infin)
die	de	pron(rel)
moegentheit	mogendheid	n(sing)
gots	god	n(prop)
hrt	hart	n(sing)
dit	dit	pron(dem)
bediet	beduiden	v(fin,pres,lex)
dyet	die+het	pron(rel)+pron(pers,3,sing)
siet	zien	v(imp)
dat	dat	pron(dem)
is	zijn	v(fin,pres,aux_cop)
idt	hebben	adv(gener)
geweer	geweren	adj()
verstaet	verstaan	v(imp)
die	die	pron(rel)
daet	daad	n(sing)
tot	tot	adp()
onser	ons	pron(poss)
beholdinge	behouden	N(sing)
voor	voor	Adp()
verdryet	verdriet	N(sing)
dat	dat	Pron(dem)
is	zijn	v(fin,pres,aux_cop)
ons	wij	pron(pers,1,plu)
tverlaet	het+verblijden	Art(def)+N(sing)
ghy	gij	Pron(pers,2,plu)
prinssen	prins	V(infin)
van	van	adp()
got	god	n(sing)
vercoren	verkiezen	v(participle,past)
orboren	orbaren	v(infin)
onse	ons	Pron(poss)
stadt	stad	n(sing)
des	de	Art(def)
vreden	vrede	N(sing)
versint	verzinnen	v(participle,past)
bemint	beminnen	v(participle,past)
daer	daar	Adv(dem)
en	ne	Adv(neg)
is	zijn	v(fin,pres,aux_cop)
geen	geen	pron(indef)
godes	god	n(sing)
toren	toorn	n(sing)
die	de	art(def)
doot	dood	adj()
licht	licht	n(sing)
daer	daar	Adv(dem)
verslynt	verslinden	V(fin,pres,lex)
