salich	zalig	adj()
moet	moeten	v(fin,pres,aux_cop)
die	de	art(def)
man	man	n(sing)
wesen	wezen	v(infin)
die	die	pron(rel)
den	de	Art(def)
heer	heer	N(sing)
'	?	punc(quest)
wel	wel	adv(gener)
ontsiet	ontzien	v(fin,pres,lex)
en	en	adv(neg)
syn	zijn	v(fin,pres,aux_cop)
weghen	weg	N(plu)
ghepresen	prijzen	V(participle,past)
houdt	houden	V(fin,pres,lex)
en	en	Conj(coord)
hem	hij	Pron(pers,3,sing)
eer	eer	conj(subord)
biet	bieden	v(fin,pres,lex)
want	want	conj(coord)
van	van	adp()
dwerck	de+welke	Art(def)+N(sing)
synder	zijn+daar	V(fin,pres,aux_cop)+Pron(dem)
handen	hand	N(plu)
sal	zullen	V(fin,pres,aux_cop)
hy	hij	Pron(pers,3,sing)
met	met	Adp()
vrolyckheyt	vrolijkheid	N(sing)
leuen	leven	n(sing)
en	en	Conj(coord)
vry	vrij	adj()
van	van	Adp()
schanden	schande	N(sing)
wort	worden	V(fin,pres,aux_cop)
hem	hij	Pron(pers,3,sing)
voorspoet	voorspoed	N(sing)
bereyt	bereiden	V(participle,past)
als	als	Conj(comp)
den	de	art(def)
wyngaert	wijngaard	N(sing)
vruchtbare	vruchtbaar	n(sing)
sal	zullen	v(fin,pres,aux_cop)
syn	zijn	pron(poss)
huysvrouwe	huisvrouw	n(sing)
syn	zijn	v(fin,pres,aux_cop)
brenghend	brengen	adj()
'	?	punc(quest)
int	het+in	art(def)+adp()
openbare	openbaar	Adj()
vruchten	vrucht	n(plu)
voorts	voorts	Adv(gener)
goet	goed	Adj()
en	en	Conj(coord)
fyn	fijn	adj()
als	als	Conj(comp)
plantkens	punt	N(plu)
der	de	art(def)
olyuen	olijf	n(plu)
sullen	zullen	v(fin,pres,aux_cop)
staen	staan	v(infin)
ghemaniert	minderen	v(participle,past)
syn	zijn	v(fin,pres,aux_cop)
kynders	kind	n(plu)
sonder	zonder	adp()
kyuen	lijf	n(sing)
om	om	adp()
syn	zijn	pron(poss)
tafl	tafel	n(sing)
verchiert	versieren	v(participle,past)
siet	zien	V(imp)
met	met	Adp()
alsulcker	alzulk	pron(dem)
eere	eer	n(sing)
wordt	worden	V(fin,pres,aux_cop)
hy	hij	Pron(pers,3,sing)
ghebenedijt	gebenedijd	Adj()
die	de	Pron(rel)
vreesende	vrezen	N(sing)
den	de	Art(def)
heere	heer	N(sing)
tquaet	het+kwaad	Art(def)+N(sing)
schout	schuld	N(sing)
tot	tot	Adp()
alder	al+de	Num(indef)+Art(def)
tijt	tijd	N(sing)
den	de	Art(def)
godt	god	N(sing)
van	van	Adp()
sion	sion	N(sing)
hooghe	hoog	Adj()
v	gij	Pron(pers,2,plu)
des	de	Art(def)
'	?	punc(quest)
weldaden	weldaad	N(plu)
doet	doen	v(fin,pres,lex)
dat	dat	conj(subord)
noch	nog	adv(gener)
sien	zien	v(infin)
sal	zullen	v(fin,pres,aux_cop)
v	gij	pron(pers,2,plu)
ooghe	oog	n(sing)
ierusalems	jeruzalem	n(prop)
voorspoet	voorspoed	N(sing)
ghy	gij	Pron(pers,2,plu)
sult	zullen	V(fin,pres,aux_cop)
wt	uit	Adp()
uwen	uw	pron(poss)
sade	zaad	N(sing)
dubbelen	dubbel	n(plu)
voorspoet	voorspoed	N(sing)
sien	zien	V(infin)
en	en	Conj(coord)
gheluck	geluk	N(sing)
en	en	Conj(coord)
ghenade	genade	N(sing)
aen	aan	Adp()
israel	israel	N(prop)
gheschien	geschieden	V(infin)
