als	als	Conj(comp)
godt	god	N(sing)
verlost	verlossen	V(participle,past)
heeft	hebben	V(fin,pres,aux_cop)
israel	israel	N(prop)
wt	uit	Adp()
de	de	Art(def)
gheuanckenisse	gevangenis	n(sing)
fel	fel	Adj()
soo	zo	Adv(resum)
docht	dunken	V(fin,past,aux_cop)
ons	wij	Pron(pers,1,plu)
dat	dat	Conj(subord)
wy	wij	Pron(pers,1,plu)
vastelyck	vastelijk	Adv(gener)
maer	maar	Conj(coord)
wat	wat	Pron(inter)
en	ne	Conj(coord)
droomden	dromen	N(plu)
blydelyck	blijdelijk	Adv(gener)
ghenoech	genoeg	adv(gener)
hadden	hebben	v(fin,past,aux_cop)
toens	tonen	n(sing)
onse	ons	pron(poss)
monden	mond	n(plu)
te	te	adp()
doen	doen	v(infin)
om	om	adp()
syn	zijn	Pron(poss)
eer	eer	N(sing)
'	?	punc(quest)
te	te	adp()
verconden	verscheiden	v(infin)
ieghelyc	iegelijk	adj()
sey	zeggen	V(fin,pres,lex)
als	als	Conj(subord)
hy	hij	Pron(pers,3,sing)
dit	dit	Pron(dem)
sach	zien	V(fin,past,lex)
dit	dit	pron(dem)
is	zijn	v(fin,pres,aux_cop)
gods	god	N(sing)
werck	werk	N(sing)
soomen	som	Pron(resum)+Pron(indef)
sien	zien	V(infin)
mach	mogen	V(fin,pres,aux_cop)
godt	god	N(sing)
gaf	geven	V(fin,past,lex)
ons	wij	Pron(pers,1,plu)
seker	zeker	adj()
op	op	adp()
die	de	art(def)
tijt	tijd	n(sing)
veel	veel	num(indef)
goets	goed	N(sing)
en	ne	adv(neg)
rusten	rusten	v(fin,pres,lex)
met	met	adp()
iolijt	jolijt	n(sing)
van	van	adp()
hem	hij	pron(pers,3,sing)
alleen	alleen	adv(gener)
ontfanghen	ontvangen	V(infin)
wy	wij	Pron(pers,1,plu)
al	al	Adv(gener)
tgoet	goed+het	n(sing)+art(def)
dat	dat	Conj(subord)
wy	wij	Pron(pers,1,plu)
nou	nu	Adv(dem)
hebben	hebben	V(fin,pres,aux_cop)
vry	vrij	Adj()
hier	hier	Adv(dem)
om	om	Adp()
brenckt	brengen	V(fin,pres,lex)
weer	zijn	N(sing)
wt	uit	Adp()
met	met	Adp()
verblyden	verblijden	V(infin)
v	uw	Pron(poss)
volck	volk	N(sing)
noch	noch	Conj(coord)
gheuanghen	gevangen	V(infin)
in	in	adp()
lyden	lijden	N(plu)
ghelyck	gelijk	Adv(gener)
oft	of	Conj(coord)
ghy	gij	Pron(pers,2,plu)
veldt	veld	N(sing)
berch	berg	N(sing)
en	een	art(indef)
dal	dal	n(sing)
met	met	Adp()
dau	dauw	N(sing)
veruerst	vervrezen	V(participle,past)
ouer	over	adp()
al	al	Adv(gener)
sy	zij	Pron(pers,3,plu)
die	die	Pron(rel)
in	in	Adp()
tranen	traan	n(plu)
ierst	eerst	num(ord)
ghesaeyt	zaaien	v(participle,past)
hebben	hebben	v(infin)
sullen	zullen	v(fin,pres,aux_cop)
worden	worden	v(infin)
ghepaeyt	gepaard	v(participle,past)
en	en	adv(neg)
eerbaerlyck	eerbaarlijk	Adv(gener)
worden	worden	V(fin,past,aux_cop)
verheucht	verheugd	adj()
als	als	Conj(comp)
den	de	Art(def)
maeytyt	mohammed	N(sing)
aencoemt	aannemen	V(fin,pres,lex)
met	met	Adp()
vreucht	vreugde	N(sing)
maer	maar	Conj(coord)
wel	wel	Adv(gener)
is	zijn	V(fin,pres,aux_cop)
waer	waar	adj()
dat	dat	Conj(subord)
sy	zij	Pron(pers,3,plu)
in	in	Adp()
weene	ween	N(sing)
saeyen	zaaien	n(plu)
sullen	zullen	v(fin,pres,aux_cop)
heurlier	heerlijk	adj()
saet	zaad	n(sing)
reene	rein	Adj()
maer	maar	Conj(coord)
al	al	Adv(gener)
verheugende	verheugen	v(participle,pres)
sullen	zullen	V(fin,pres,aux_cop)
sy	zij	Pron(pers,3,plu)
draghen	dragen	V(infin)
heurlieder	overlijden	N(sing)
schoouen	schouwen	V(infin)
met	met	Adp()
behaghen	behagen	V(infin,subst)
