ghelyck	gelijk	Adv(gener)
den	de	Art(def)
dagheraet	dageraad	N(sing)
hem	hij	Pron(pers,3,sing)
lustich	lustig	adj()
openbaert	openbaren	V(fin,pres,lex)
des	de	Art(def)
morghens	morgen	n(sing)
inden	in+de	adp()+art(def)
oosten	oosten	N(plu)
en	ne	adv(neg)
compt	komen	V(fin,pres,lex)
vry	vrij	adj()
onueruaert	onvervaard	adj()
die	de	Pron(rel)
tsnachts	des+nacht	art(def)+n(sing)
waren	zijn	V(fin,past,aux_cop)
beswaert	bezwaren	V(participle,past)
deur	door	Adp()
syn	zijn	Pron(poss)
claricheyt	klaarheid	N(sing)
troosten	troosten	N(plu)
alsoo	alzo	adv(gener)
word	worden	V(fin,pres,aux_cop)
mynen	mijn	pron(poss)
gheest	geest	N(sing)
oock	ook	Adv(gener)
verfraeyt	vergrammen	V(fin,pres,lex)
aldermeest	allermeest	Adv(gener)
deur	door	Adp()
v	gij	Pron(poss)
reyn	rein	Adj()
minlyck	minnelijk	adj()
wesen	wezen	V(infin)
en	en	adv(neg)
v	gij	pron(pers,2,plu)
bruyn	bruin	N(sing)
oochskens	zij+zoeken	N(plu)
claer	klaar	Adj()
en	en	Conj(coord)
v	gij	Pron(poss)
schoon	schoon	Adj()
blondich	bloedig	Adj()
haer	haar	Pron(poss)
cunnen	kunnen	N(plu)
myn	mijn	Pron(poss)
pyn	pijn	N(sing)
ghenesen	genezen	V(participle,past)
ghelyck	gelijk	adv(gener)
den	de	Art(def)
suyden	zuiden	N(plu)
wint	wind	n(sing)
die	die	pron(rel)
flora	storax	n(sing)
seer	zeer	Adv(gener)
bemint	beminnen	V(fin,pres,lex)
int	in+het	Adp()+Art(def)
suetste	zoet	N(sing)
vanden	van+de	art(def)+adp()
meye	mei	n(prop)
de	de	Art(def)
bloemkens	bloem	N(plu)
groeyen	groeien	adj()
doet	doen	V(fin,pres,lex)
diemen	die+men	pron(rel)+pron(indef)
siet	zien	v(fin,pres,lex)
ouervloet	overvloed	N(sing)
in	in	Adp()
bosch	bos	adj()
berch	berg	n(sing)
en	ne	adv(neg)
valleye	vallen+zij	n(sing)
alsoo	alzo	Adv(gener)
can	kunnen	V(fin,pres,aux_cop)
uwen	uw	Pron(poss)
sanck	zang	N(sing)
en	en	Conj(coord)
v	gij	Pron(poss)
schoon	schoon	Adj()
aenschyn	aanschijn	N(sing)
blanck	blank	Adj()
myn	mijn	Pron(poss)
swaricheyt	zwaarheid	N(sing)
verdryuen	verdrijven	V(infin)
en	en	adv(neg)
doen	doen	V(infin)
my	ik	Pron(pers,1,sing)
met	met	Adp()
iolyt	jolijt	N(sing)
in	in	adp()
desen	deze	pron(dem)
sueten	zoet	adj()
tyt	tijd	n(sing)
v	uw	pron(poss)
gratien	gratie	n(sing)
beschryuen	beschrijven	v(infin)
